{
    "number": 2,
    "texture": "TexDawn",
    "music": "MusicGame_2",
    "bricks": [
        [ 0, 0, 0, 0, 0, 0, 1, 0, 0, 0, 0 ],
        [ 0, 0, 0, 0, 1, 1, 1, 1, 1, 0, 0 ],
        [ 0, 0, 0, 0, 1, 1, 1, 1, 1, 0, 0 ],
        [ 0, 0, 0, 0, 0, 1, 1, 1, 1, 1, 0 ],
        [ 0, 0, 0, 0, 0, 1, 1, 1, 1, 1, 0 ],
        [ 0, 0, 0, 0, 0, 1, 1, 1, 1, 1, 0 ],
        [ 0, 0, 0, 0, 0, 1, 1, 1, 1, 1, 0 ],
        [ 0, 0, 0, 0, 0, 1, 1, 1, 1, 1, 0 ],
        [ 0, 0, 0, 0, 1, 1, 1, 1, 1, 0, 0 ],
        [ 1, 1, 0, 0, 1, 1, 1, 1, 1, 0, 0 ],
        [ 1, 1, 1, 0, 0, 0, 1, 0, 0, 0, 0 ],
        [ 1, 1, 1, 1, 0, 0, 1, 0, 0, 0, 0 ],
        [ 0, 1, 1, 1, 0, 0, 1, 0, 1, 1, 1 ],
        [ 0, 0, 1, 1, 1, 1, 1, 1, 1, 1, 0 ],
        [ 0, 0, 1, 1, 1, 1, 1, 1, 1, 1, 0 ],
        [ 0, 0, 1, 1, 1, 1, 1, 1, 1, 1, 0 ],
        [ 0, 1, 1, 1, 1, 1, 1, 1, 1, 0, 0 ],
        [ 0, 1, 1, 1, 1, 1, 1, 1, 1, 0, 0 ],
        [ 0, 0, 1, 0, 1, 1, 1, 1, 0, 0, 0 ],
        [ 0, 0, 0, 0, 0, 1, 1, 0, 0, 0, 0 ]

    ]

}