{
    "number": 3,
    "texture": "TexSunset",
    "music": "MusicGame_1",
    "bricks": [
        [ 0, 0, 0, 0, 0, 0, 0, 0, 0, 0, 0 ],
        [ 0, 0, 0, 0, 0, 0, 0, 0, 0, 0, 0 ],
        [ 0, 0, 0, 0, 0, 0, 0, 0, 0, 0, 0 ],
        [ 0, 0, 1, 0, 0, 0, 0, 0, 1, 0, 0 ],
        [ 0, 1, 1, 0, 0, 0, 0, 0, 1, 1, 0 ],
        [ 0, 1, 1, 1, 0, 0, 0, 1, 1, 1, 0 ],
        [ 0, 0, 1, 1, 0, 0, 0, 1, 1, 0, 0 ],
        [ 0, 0, 0, 1, 1, 0, 1, 1, 0, 0, 0 ],
        [ 0, 0, 0, 0, 1, 1, 1, 0, 0, 0, 0 ],
        [ 0, 0, 0, 0, 1, 1, 1, 0, 0, 0, 0 ],
        [ 0, 0, 0, 1, 1, 0, 1, 1, 0, 0, 0 ],
        [ 0, 0, 1, 1, 0, 0, 0, 1, 1, 0, 0 ],
        [ 0, 1, 1, 1, 0, 0, 0, 1, 1, 1, 0 ],
        [ 0, 1, 1, 0, 0, 0, 0, 0, 1, 1, 0 ],
        [ 0, 0, 1, 0, 0, 0, 0, 0, 1, 0, 0 ],
        [ 0, 0, 0, 0, 0, 0, 0, 0, 0, 0, 0 ],
        [ 0, 0, 0, 0, 0, 0, 0, 0, 0, 0, 0 ],
        [ 0, 0, 0, 0, 0, 0, 0, 0, 0, 0, 0 ],
        [ 0, 0, 0, 0, 0, 0, 0, 0, 0, 0, 0 ],
        [ 0, 0, 0, 0, 0, 0, 0, 0, 0, 0, 0 ]

    ]

}