{
    "number": 1,
    "texture": "TexSkullIsland",
    "music": "MusicGame_1",
    "bricks": [
        [ 0, 0, 0, 1, 1, 1, 1, 1, 0, 0, 0 ],
        [ 0, 0, 1, 1, 1, 1, 1, 1, 1, 0, 0 ],
        [ 0, 1, 1, 1, 0, 1, 0, 1, 1, 1, 0 ],
        [ 0, 1, 1, 0, 0, 1, 0, 0, 1, 1, 0 ],
        [ 1, 1, 1, 0, 0, 1, 0, 0, 1, 1, 1 ],
        [ 1, 1, 1, 0, 0, 1, 0, 0, 1, 1, 1 ],
        [ 1, 1, 1, 1, 1, 1, 1, 1, 1, 1, 1 ],
        [ 1, 1, 1, 1, 1, 0, 1, 1, 1, 1, 1 ],
        [ 1, 1, 1, 1, 0, 0, 0, 1, 1, 1, 1 ],
        [ 0, 1, 1, 1, 0, 0, 0, 1, 1, 1, 0 ],
        [ 0, 1, 1, 1, 0, 1, 0, 1, 1, 1, 0 ],
        [ 0, 1, 1, 1, 1, 1, 1, 1, 1, 1, 0 ],
        [ 0, 0, 1, 1, 1, 1, 1, 1, 1, 0, 0 ],
        [ 0, 0, 1, 1, 1, 1, 1, 1, 1, 0, 0 ],
        [ 0, 0, 0, 1, 1, 1, 1, 1, 0, 0, 0 ],
        [ 0, 0, 0, 1, 0, 1, 0, 1, 0, 0, 0 ],
        [ 0, 0, 0, 1, 0, 1, 0, 1, 0, 0, 0 ],
        [ 0, 0, 0, 0, 0, 0, 0, 0, 0, 0, 0 ],
        [ 0, 0, 0, 0, 0, 0, 0, 0, 0, 0, 0 ],
        [ 0, 0, 0, 0, 0, 0, 0, 0, 0, 0, 0 ]

    ]

}